#######S#############
#                   #
#      M            #
#                   #
#               M   #
#                   #
############E########