####S############
#		        #
#	m 	        #
#		        #
#	m	        #
#		        #
#		        #
#######E#########